NO /textures/wall_north.xpm
SO /textures/wall_south.xpm
WE textures/wall_west.xpm
EA textures/wall_east.xpm

F 220,100,0
C 225,30,0

1111111111111111
1000000000110001
1011000000110001
1001000000000001
10000000N0000001
1000000000000001
1111111111111111
