NO bonus/textures/wall_north.xpm
SO bonus/textures/wall_south.xpm
WE bonus/textures/wall_west.xpm
EA bonus/textures/wall_east.xpm

F 110,110,110
C 0,0,0

111111
11D1D1
100001
10N001
100001
111111
